1111111111
0010000011
1010111011
1000000111
1110110000
1111111111
1111111111
1111111111
1111111111
1111111111